%%%%%%%%%
%   P   %
%   %   %
%.  % . %
%   %   %
%       %
%       %
% . % . %
%   %   %
% G   G %
%%%%%%%%%
